1 1 1 1 1 1 1 1 1 1 6 1 1 1 1 1 1 1 1 1
1 0 0 0 0 0 1 0 0 0 0 0 0 0 1 0 0 0 0 1
1 0 0 2 0 0 0 0 0 0 0 0 0 0 0 0 0 0 0 1
1 0 0 0 0 0 1 0 0 0 0 0 0 0 1 0 0 0 0 1
1 0 0 0 0 0 1 0 0 0 0 0 0 0 1 0 0 0 0 1
1 1 1 1 1 1 1 0 0 0 0 0 0 0 1 1 1 1 1 1
1 5 0 0 0 0 1 0 0 0 0 0 0 0 1 0 0 3 0 1
1 0 0 0 0 0 1 0 0 0 0 0 0 0 1 0 3 5 3 1
1 1 1 0 1 1 1 1 1 1 0 1 1 1 1 0 0 3 0 1
1 0 0 0 0 0 1 0 0 0 0 0 0 0 1 0 0 0 0 1
1 0 0 0 0 0 0 0 0 0 0 0 0 0 0 0 0 0 0 1
1 0 0 0 0 0 1 0 0 0 8 0 2 0 1 0 0 0 0 1
1 0 0 0 0 0 1 0 0 0 0 0 0 0 1 0 0 0 0 1
1 0 0 0 0 0 1 0 0 0 0 0 0 0 1 0 4 0 0 1
1 1 1 1 1 1 1 1 1 1 7 1 1 1 1 1 1 1 1 1



