41111111112111111114
10000050000000600001
200E00000LP0L000E002
10000050000000600001
10000050000000600001
17777750000000677771
10000057707777700001
10000050000000600001
100E005000E000600E01
10000050000000600001
100L0000000000000001
100B005000B000600B01
100E005000000060E001
10000050000000600001
41111111112111111114 




