11111111116111111111
10000010000000100001
10000000000050000201
10040010004000100001
10000010000000102001
11111110000000111111
10000010000000100001
10000010000000104001
10040010000000100001
10000010002200100021
10020000200020000001
10000010208020100201
10000010000000100001
10000010002000100001
11111111111111111111



