11111111112111111111
10000010000000100001
200E00000LP0L000E002
10000010000000100001
10000010000000100001
11111110000000111111
10000011101111100001
10000010000000100001
100E001000E000100E01
10000010000000100001
100L0000000000000001
100B001000B000100B01
100E001000000010E001
10000010000000100001
11111111112111111111




