11111111111111111611
10000000000000500001
10000000000000000001
11011111111111111111
10000000000000000001
10002000000000000001
11111111111111110001
10000000000000010001
10020000040000000051
10000000000000013331
11111111111111111011
10000000000000000001
10000000008000000001
10000000000000000001
11111111117111111111



