41111111111111111214
10000000000000000001
10000000000000000001
10111111111111111111
100000000000000000E1
101111111111111111L1
10100000000000000101
10100000000000000101
10100000000000000101
10100011111111000101
10100010000001000101
10100010010101000000
1010001001P1010001B1
10000000010100000001
41111111113111111114



