11111111116111111111
10000010000000100001
10040000000000004001
10000010002000100001
10000010080000100001
11111110005000111111
10000011101111100001
10000010000000100001
10040010004000100401
10000010000000100001
10000000000000000001
10020010002000100201
60040010000000104001
10000010000000100001
11111111111111111111



