41111111111111111114
10000010000000100001
1L0B0000000000000001
10000010000000100001
10000010000000100001
11111110000000111111
1E000010000000100001
10000010000000100002
11101111110111100001
10000010000000100001
10000000000000000001
1000001000P0B0100001
10000010000000100001
1000001000000010E001
41111111113111111114





