11111111116111111111
10000010000000100001
100B0000000000000001
10000010000000100001
10000010000000100001
11111110000000111111
1E000010000000100001
10000010000000100L01
11101111110111100001
10000010000000100001
10000000000000000001
1000001000P0B0100001
10000010000000100001
1000001000000010E001
11111111117111111111




