41111111111111111114
10000050000000600001
100E00000LP0L000E002
10000050000000600001
10000050000000600001
17777780000000977771
10000057707777600001
10000050000000600001
200E005000E000600E02
10000050000000600001
100L0000000000000003
100B005000B000600B01
100E005000000060E001
10000050000000600001
41111111111111111114 



