11111111116111111111
10000010000000100001
10020000000000000001
10000010000000100001
10000010000000100001
11111110000000111111
15000010000000100001
10000010000000100501
11101111110111100001
10000010000000100001
10000000000000000001
10000010008020100001
10000010000000100001
10000010000000104001
11111111117111111111



