41111111113111111114
10000050000000600001
100F000000P000000001
10000050000000600H01
10000050000000600001
17777780000000977771
10000057707777600001
10000050000000600001
1000005000C000600001
1000005000000060V001
10000000000000000002
100B005000B000600B01
10000050000000600001
10000050000000600001
41111111111111111114 





