41111111111111111114
10000000000000E00001
10000000000000000001
11011111111111111111
10000000000000000001
1000B000000000000001
11111111111111110001
10000000000000010001
30P00B000L00000000E1
10000000000000010001
11111111111111111011
10000000000000000001
10000000000000000001
10000000000000000001
41111111112111111114



