11111111116111111111
10000010000000100001
10040000000000004001
10000010000000100001
10000010000000100001
11111110005000111111
10000010000000100001
10000010000000100001
10040010000000100401
10000010000000100001
10000000000000000001
10000010008000100001
60040010000000104001
10000010000000100001
11111111111111111111



