41111111112111111114
10000050000000600001
100F00000LP0L0000001
10000050000000600H01
10000050000000600001
17777780000000977771
10000057707777600001
10000050000000600001
1000005000C000600001
1000005000000060V001
100L0000000000000001
100B005000B000600B01
10000050000000600001
10000050000000600001
41111111113111111114 




