11111111111111111611
10000000000000000001
10000000000000000001
10111111111111111111
10000000000000000051
10111111111111111141
10100000000000000101
10100000000000000101
10100000000000000101
10100011111111000101
10100010000001000101
10100010010101000000
10100010018101000121
10000000010100000001
11111111117111111111



